6 6 7 7 7 8 6 6 6 7 8 6 6 7 6 6 7 6 7 7 6 7 6 6 14 7 6 6 7 8 6 7 6 6 15 6 6 7 7 6 7 6 8 6 16 6 7 6 8 6 6 6 7 7 7 6 7 6 6 6
6 11 11 0 2 0 3 12 20 3 0 11 5 5 3 8 10 11 13 12 20 11 11 6 14 6 5 5 12 0 0 11 5 6 14 8 5 5 1 12 5 5 11 6 15 6 5 0 5 0 0 0 6 1 12 1 0 1 5 6
7 11 0 0 2 0 0 3 13 2 5 0 11 10 19 7 10 1 13 1 0 11 5 7 16 7 5 13 3 2 0 11 5 6 15 6 5 1 0 13 3 0 11 7 15 7 0 5 0 5 0 0 0 0 13 1 4 0 5 8
7 2 0 0 4 0 5 0 0 0 2 5 0 0 1 6 5 0 0 2 11 19 5 6 14 7 2 0 2 0 0 1 18 6 14 7 11 3 2 1 0 0 0 6 14 6 2 0 0 2 0 0 0 1 0 0 3 11 5 7
6 1 0 0 5 5 1 0 0 0 5 18 0 0 5 6 3 1 0 0 11 0 1 6 14 6 0 2 0 0 3 1 0 7 15 7 19 2 2 0 2 0 0 7 14 7 10 0 0 1 0 0 6 19 20 11 11 5 10 6
8 0 2 1 0 0 3 0 4 2 5 1 0 4 0 7 0 5 0 0 1 0 0 8 14 6 5 4 5 1 0 0 2 8 16 7 19 0 2 0 0 5 5 8 15 6 10 1 0 1 0 4 6 7 6 6 6 6 6 6
6 11 2 0 0 3 0 2 0 4 0 4 3 0 2 7 0 0 0 2 1 11 0 6 15 6 10 0 5 0 0 3 3 6 15 6 10 11 3 1 2 0 0 6 16 6 0 1 0 2 4 0 8 17 17 17 17 17 17 17
6 11 0 0 0 0 4 2 11 11 1 0 0 0 0 6 3 1 0 5 0 0 1 6 15 6 11 0 0 0 1 0 0 7 6 6 0 3 2 0 0 0 0 6 6 7 0 0 0 0 0 1 6 6 7 7 7 6 6 6
7 10 18 0 4 0 0 1 11 11 10 4 1 5 3 7 11 0 0 2 0 0 0 7 16 6 11 11 0 1 0 0 0 2 1 3 0 1 0 1 0 0 0 0 0 0 0 3 0 0 0 1 1 1 2 1 11 5 5 7
6 6 6 8 6 9 7 6 7 6 6 8 6 7 6 7 11 11 2 11 0 1 2 6 15 6 11 0 3 0 3 1 0 1 2 0 0 0 0 3 0 5 0 0 1 1 0 1 0 1 3 0 0 0 1 2 11 11 5 7
6 5 5 1 0 0 0 2 0 0 2 12 20 5 5 7 11 11 0 1 0 1 0 7 15 7 0 1 0 3 0 0 1 3 2 0 0 1 0 0 0 0 5 0 0 2 0 0 0 1 0 1 0 5 0 0 1 11 5 8
7 5 13 3 1 0 2 0 0 2 13 13 2 3 5 6 11 3 0 0 3 0 5 7 15 8 0 0 0 19 7 6 7 11 0 0 6 7 6 11 0 0 0 7 6 7 11 1 0 0 3 0 6 18 18 2 2 2 10 6
7 2 0 0 5 3 0 0 0 1 0 2 0 0 5 6 0 0 0 5 2 2 5 6 14 6 0 1 0 11 6 14 6 5 0 0 7 16 6 10 0 0 5 6 15 6 11 11 0 2 0 0 7 6 6 7 6 6 7 7
6 0 0 5 4 3 1 0 2 5 5 3 3 0 3 6 19 1 0 0 0 5 11 6 15 7 20 20 5 5 6 16 6 11 5 10 6 14 6 0 0 0 5 6 14 8 10 0 1 0 1 0 8 17 17 17 17 17 17 17
8 2 3 0 2 0 0 0 0 0 0 3 0 1 0 8 10 0 4 2 0 0 10 6 15 6 6 7 7 7 6 15 6 7 8 7 6 15 6 7 8 6 6 7 16 6 19 18 0 0 0 2 6 7 7 6 6 7 6 7
7 5 0 3 1 0 5 2 5 1 0 3 2 0 11 6 10 11 2 0 18 5 10 7 15 16 15 14 15 15 14 16 14 15 15 14 15 14 14 15 14 16 15 15 16 7 0 1 0 2 0 0 6 11 11 0 12 0 5 6
7 1 2 1 0 0 0 0 0 4 5 0 0 11 11 7 6 7 6 9 6 7 6 8 6 7 6 6 7 6 6 6 6 7 7 7 6 6 6 7 7 6 7 6 6 6 0 0 3 0 1 0 2 2 0 2 13 2 10 8
7 3 11 5 3 0 0 1 0 0 0 3 0 0 0 0 1 1 0 0 0 1 1 1 0 2 3 1 0 2 3 0 2 0 1 0 0 3 1 0 0 2 0 0 0 1 0 5 1 1 0 2 2 0 0 3 0 3 11 7
6 5 11 3 0 2 0 2 4 0 3 0 2 0 0 0 2 0 1 4 3 2 0 3 0 1 0 0 2 1 0 2 1 2 0 1 3 3 1 0 0 0 1 1 0 2 0 5 5 0 2 0 6 0 3 20 20 5 5 7
6 11 10 0 0 0 0 0 0 1 0 0 11 18 18 6 5 3 2 0 1 3 1 6 6 7 7 6 6 0 0 0 1 0 5 3 0 0 5 2 0 5 0 0 0 1 2 0 2 4 0 11 6 7 6 6 7 6 6 6
6 11 10 5 0 0 1 0 0 3 19 10 19 19 5 7 5 11 1 0 0 0 1 6 17 17 17 17 6 2 0 3 2 0 0 2 1 1 0 5 5 3 0 0 0 1 0 0 0 0 10 11 8 17 17 17 17 17 17 17
6 6 7 6 6 0 6 8 7 6 6 7 7 6 6 6 7 6 7 6 7 0 3 7 6 6 6 17 7 14 14 0 1 0 4 1 0 1 0 0 2 0 3 0 2 0 0 2 0 2 0 11 6 6 6 6 6 6 6 6
17 17 17 17 6 9 6 17 17 17 17 17 17 17 17 17 17 17 17 6 0 1 2 3 5 11 6 17 6 15 15 14 14 0 0 14 1 0 5 2 4 3 5 0 0 0 0 5 0 5 5 0 6 11 11 0 19 11 11 6
7 6 7 7 6 0 7 6 6 8 6 7 6 7 7 6 6 6 17 7 5 0 3 11 19 19 8 17 6 17 17 16 15 14 14 14 1 0 0 0 1 0 1 0 3 0 0 2 0 0 0 2 7 18 0 0 5 5 11 7
6 10 5 5 2 0 0 2 0 0 13 12 20 10 4 5 5 6 17 6 0 2 0 2 11 5 6 17 6 17 17 17 17 16 15 15 14 0 0 1 0 0 1 0 0 0 2 2 0 5 1 0 7 0 0 3 2 0 0 8
8 11 1 1 0 0 0 0 3 0 1 2 0 0 1 3 5 8 17 7 10 0 0 0 2 5 6 17 6 17 17 17 17 17 17 14 14 14 14 14 0 0 2 1 0 1 2 0 5 1 0 0 8 0 0 0 0 0 0 6
6 3 2 0 0 0 1 2 0 0 3 2 0 2 3 0 11 7 17 6 11 1 1 0 5 5 6 17 6 17 17 17 17 17 17 17 17 16 16 16 14 0 4 0 2 0 0 3 5 1 0 0 0 1 0 1 0 5 0 7
7 10 5 3 11 10 6 8 7 1 0 0 1 11 11 3 11 7 17 7 11 5 0 2 2 0 6 17 7 17 17 17 17 17 17 17 17 17 17 17 14 14 0 6 6 7 0 3 0 2 2 0 0 0 0 1 0 3 5 6
6 5 5 1 11 11 7 17 7 18 10 10 5 19 11 11 11 6 17 6 5 19 0 0 5 5 6 17 7 17 17 17 17 17 17 17 17 17 17 17 14 16 14 7 17 7 0 0 0 0 0 0 6 19 19 0 1 5 5 6
6 6 7 8 6 6 6 17 6 6 7 7 7 6 6 8 6 6 17 7 6 7 7 8 6 6 6 17 6 17 17 17 17 17 17 17 17 17 17 17 17 16 14 6 17 6 6 6 8 6 6 7 7 7 6 8 6 6 6 7 




